#.S.....
##.#.###
........
.####.#.
.....#..
..#.F#..
..#####.
#.......